0 1 1 1 1 1 1 1 1 1 1 1 1 1 1 2
3 4 4 4 4 4 4 4 4 4 4 4 4 4 4 5
3 4 4 4 4 4 4 4 4 4 4 4 4 4 4 5
3 4 4 4 4 4 4 4 4 4 4 4 4 4 4 5
3 4 4 4 4 4 4 4 4 4 4 4 4 4 4 5
3 4 4 4 4 4 4 4 4 4 4 4 4 4 4 5
6 7 8 7 8 7 8 7 8 7 8 7 8 7 8 9
10 11 12 11 12 11 12 11 12 11 12 11 12 11 12 13
10 11 12 11 12 11 12 11 12 11 12 11 12 11 12 13
10 11 12 11 12 11 12 11 12 11 12 11 12 11 12 13
10 11 12 11 12 11 12 11 12 11 12 11 12 11 12 13
10 11 12 11 12 11 12 11 12 11 12 11 12 11 12 13
10 11 12 11 12 11 12 11 12 11 12 11 12 11 12 13
10 11 12 11 12 11 12 11 12 11 12 11 12 11 12 13
10 11 12 11 12 11 12 11 12 11 12 11 12 11 12 13
14 15 16 15 16 15 17 18 18 19 16 15 16 15 16 20