22 23 23 23 23 23 23 23 23 23 23 23 23 23 23 24
25 26 26 26 26 26 26 26 26 26 26 26 26 26 26 27
25 26 26 26 26 26 26 26 26 26 26 26 26 26 26 27
25 26 26 26 26 26 26 26 26 26 26 26 26 26 26 27
28 31 31 31 31 31 31 31 31 31 31 31 31 31 31 34
29 32 32 32 32 32 32 32 32 32 32 32 32 32 32 35
29 32 32 32 32 32 32 32 32 32 32 32 32 32 32 35
6 7 8 7 8 7 8 7 8 7 8 7 8 7 8 9
10 11 12 11 12 11 12 11 12 11 12 11 12 11 12 13
10 11 12 11 12 11 12 11 12 11 12 11 12 11 12 13
10 11 12 11 12 11 12 11 12 11 12 11 12 11 12 13
10 11 12 11 12 11 12 11 12 11 12 11 12 11 12 13
10 11 12 11 12 11 12 11 12 11 12 11 12 11 12 13
10 11 12 11 12 11 12 11 12 11 12 11 12 11 12 13
10 11 12 11 12 11 12 11 12 11 12 11 12 11 12 13
14 15 16 15 16 15 17 18 19 20 16 15 16 15 16 21