37 38 38 38 38 38 38 38 38 38 38 38 38 38 38 39
40 41 41 41 41 41 41 41 41 41 41 41 41 41 41 42
40 41 41 41 41 41 41 41 41 41 41 41 41 41 41 42
40 41 41 41 41 41 41 41 41 41 41 41 41 41 41 42
40 41 41 41 41 41 41 41 41 41 41 41 41 41 41 42
43 44 44 44 44 44 44 44 44 44 44 44 44 44 44 45
6 7 8 7 8 7 8 7 8 7 8 7 8 7 8 9
10 11 12 11 12 11 12 11 12 11 12 11 12 11 12 13
10 11 12 11 12 11 12 11 12 11 12 11 12 11 12 13
12 11 12 11 12 11 12 11 12 11 12 11 12 11 12 13
12 11 12 11 12 11 12 11 12 11 12 11 12 11 12 13
12 11 12 11 12 11 12 11 12 11 12 11 12 11 12 13
12 11 12 11 12 11 12 11 12 11 12 11 12 11 12 13
10 11 12 11 12 11 12 11 12 11 12 11 12 11 12 13
10 11 12 11 12 11 12 11 12 11 12 11 12 11 12 13
14 15 16 15 16 15 16 15 16 15 16 15 16 15 16 21